R 800 600

WE ./sprites/colorstone.xpm
  
NO ./sprites/bluestone.xpm
S ./sprites/greenlight.xpm
SO ./sprites/redbrick.xpm
EA ./sprites/eagle.xpm   
F 0        ,    255,0

C 255,0,0

11111111111111111111111111111111111111111111111111111111111111111111111111111
 1221100000000000000000000000000000000000000000000000000000000000000000000001
 1000001111111111111111111111111111111111111111111111111111111110111111111101
 11111111111111111111111111111111111111111111111111111111111111101111111111111
  10000000000000000000000000000000000000N00000000000000000000000000000000000111
  1111111111111111111111111111111111111111111111111111111111111111111111111111
  11111111111111111111111111111111111111111111111111111111111111111111111111111
 1221100000000000000000000000000000000000000000000000000000000000000000000001
 1000001111111111111111111111111111111111111111111111111111111110111111111101
 11111111111111111111111111111111111111111111111111111111111111101111111111111
  10000000000000000000000000000000000000000000000000000000000000000000000000111
  1111111111111111111111111111111111111111011111111111111111111111111111111111
 1111111111111111111111111111111111111111111111111111111111111111111111111111