R 800 600

SO ./sprites/redbrick.xpm
WE ./sprites/jz.xpm
EA ./sprites/eagle.xpm
NO ./sprites/bluestone.xpm
S ./sprites/barrel.xpm

C 1,111,111
F 1,100,255

        1111111111111111111111111
        1000000000110000000000001
        1011000001110000000000001
        1001000000000000000000001
111111111011000001110000000000001
100000000011000001110111111111111
11110111111111011100000010001
11110111111111011101010010001
11000000110101011100000010001
10002000000000001100000010001
1000000000000000110101001   1
1100000111010101111101111 N 111
11110111 1110101 10111101   1
11111111 1111111 111111111111