R 1600 1024

SO ./sprites/redbrick.xpm
WE ./sprites/jz.xpm
EA ./sprites/eagle.xpm
NO ./sprites/bluestone.xpm
S ./sprites/barrel.xpm
C 255,0,0
F 0,0,255


        111111 11111111111 11111111
        1000000000110000000000000
        1011000001110000002000001
        1001000000000000000000000
111111111011000001110000000000001
100000000011000001110111111111111
11110111111111011100000010001
11110111111111011101010010001
11000000110101011100000010201
10002000000000001100000010201
10000000000000001101010010201
11000001110101011111011110N0111
11110111 1110101 101111010001
11111111 1111111 111111111111
