   R 1024  768
NO ./path_to_the_north_texture
SO ./path_to_the_south_texture
WE ./path_to_the_west_texture
EA ./path_to_the_east_texture
S ./path_to_the_sprite_texture
F 100,0,152
C 255,255,0
11111111111111111111111111111111
100000000011000000000000011111111
1011000001110000000S000011111111
10010000000000001000000011111111
11111111101100000111000000000011
1000000000110100011101111111111
11110111111111011100000010001
11111111111111111111111111111
11000000110101011111101111111
10001000000000001100000010001
10000000000000001101101010001
11000001110101011111011110001
11110111 1110101 101111010001
11111111 1111111 111111111111
