    R 1080 720  

      NO ./BLUESTONE.xpm

  SO ./colorstone.xpm

 WE ./redbrick.xpm

S ./greenlight.xpm

C     30, 30, 30

F 30,155,155

EA ./eagle.xpm

1111111111111
1002200000001
1002200111111
1N022001
11111111
