R 1600 1024


WE ./sprites/colorstone.xpm

EA ./sprites/eagle.xpm

NO ./sprites/bluestone.xpm


S ./sprites/barrel.xpm
SO ./sprites/redbrick.xpm
F 255,150,50
C 50,150,255

11111
10001
10N01
10001
11111