R 1920 1080
NO ./bluestone.xpm
SO ./redbrick.xpm
WE ./jz.xpm
EA ./eagle.xpm
S ./greenlight.xpm
F 220,100,255
C 225,255,100
11111
1W001
10001
10001
11111