R 1600 1024

SO ./sprites/redbrick.xpm
WE ./sprites/jz.xpm
EA ./sprites/eagle.xpm
NO ./sprites/bluestone.xpm
S ./sprites/greenlight.xpm
C 255,0,0
F 0,0,255



        1111111111111111111111111
        1000000000110000000000001
        1011000001110000002000001
        10010000000000000N0000001
111111111011000001110000000000001
100000000011000001110111101111111111 111 111 
11111111111111111111111111
111 1    1  1111 11 111 1 11111 1111 111 1111 11 
111
11
11111111
0
0
0
1111