R 1600 1024

SO ./sprites/redbrick.xpm
WE ./sprites/jz.xpm
EA ./sprites/eagle.xpm
NO ./sprites/bluestone.xpm
S ./sprites/barrel.xpm
C 255,0,0
F 0,0,255

1111
1001
1001
1N01
1111
